Wenn nicht mehr Zahlen und Figuren

Wenn nicht mehr Zahlen und Figuren	Awe / Sublime
Sind Schlüssel aller Kreaturen	Awe / Sublime
Wenn die, so singen oder küssen,	Awe / Sublime
Mehr als die Tiefgelehrten wissen,	Awe / Sublime
Wenn sich die Welt ins freye Leben	Awe / Sublime
Und in die Welt wird zurück begeben,	Awe / Sublime
Wenn dann sich wieder Licht und Schatten	Awe / Sublime
Zu ächter Klarheit werden gatten,	Awe / Sublime
Und man in Mährchen und Gedichten	Awe / Sublime
Erkennt die wahren Weltgeschichten,	Awe / Sublime
Dann fliegt vor Einem geheimen Wort	Awe / Sublime
Das ganze verkehrte Wesen fort.	Awe / Sublime


Liebe und Frühling

Ich muß hinaus, ich muß zu dir,	Vitality
Ich muß es selbst dir sagen:	Vitality
Du bist mein Frühling, du nur mir	Vitality
In diesen lichten Tagen.	Vitality

Ich will die Rosen nicht mehr sehn,	Vitality --- Sadness
Nicht mehr die grünen Matten;	Vitality --- Sadness
Ich will nicht mehr zu Walde gehn	Vitality --- Sadness
Nach Duft und Klang und Schatten.	Vitality --- Sadness

Ich will nicht mehr der Lüfte Zug,	Vitality --- Sadness
Nicht mehr der Wellen Rauschen,	Vitality --- Sadness
Ich will nicht mehr der Vögel Flug	Vitality --- Sadness
Und ihrem Liede lauschen -	Vitality --- Sadness

Ich will hinaus, ich will zu dir,	Vitality
Ich will es selbst dir sagen:	Vitality
Du bist mein Frühling, du nur mir	Vitality
In diesen lichten Tagen!	Vitality


Der Gott der Stadt

Auf einem Häuserblocke sitzt er breit.	Suspense
Die Winde lagern schwarz um seine Stirn.	Suspense
Er schaut voll Wut, wo fern in Einsamkeit	Suspense
Die letzten Häuser in das Land verirrn.	Suspense

Vom Abend glänzt der rote Bauch dem Baal,	Beauty / Joy
Die großen Städte knien um ihn her.	Beauty / Joy
Der Kirchenglocken ungeheure Zahl	Beauty / Joy
Wogt auf zu ihm aus schwarzer Türme Meer.	Beauty / Joy

Wie Korybanten-Tanz dröhnt die Musik	Beauty / Joy
Der Millionen durch die Straßen laut.	Beauty / Joy
Der Schlote Rauch, sie Wolken der Fabrik	Beauty / Joy
Ziehn auf zu ihm, wie Duft von Weihrauch blaut.	Beauty / Joy

Das Wetter schwelt in seinen Augenbrauen.	Uneasiness
Der dunkle Abend wird in Nacht betäubt.	Uneasiness
Die Stürme flattern, die wie Geier schauen	Uneasiness
Von seinem Haupthaar, das im Zorne sträubt.	Uneasiness

Er streckt ins Dunkel seine Fleischerfaust.	Uneasiness
Er schüttelt sie. Ein Meer von Feuer jagt	Uneasiness
Durch eine Straße. Und der Glutqualm braust	Uneasiness
Und frisst sie auf, bis spät der Morgen tagt.	Uneasiness


Sonntagnachmittag

Auf faulen Straßen lagern Häuserrudel,	Beauty / Joy
Um deren Buckel graue Sonne hellt.	Beauty / Joy
Ein parfümierter, halbverrückter kleiner Pudel	Humor
Wirft wüste Augen in die große Welt.	Humor

In einem Fenster fängt ein Junge Fliegen.	Humor
Ein arg beschmiertes Baby ärgert sich.	Humor
Am Himmel fährt ein Zug, wo windge Wiesen liegen;	Beauty / Joy
Malt langsam einen langen dicken Strich.	Beauty / Joy

Wie Schreibmaschinen klappen Droschkenhufe.	Nostalgia --- Beauty / Joy
Und lärmend kommt ein staubger Turnverein.	Nostalgia --- Beauty / Joy
Aus Kutscherkneipen stürzen sich brutale Rufe.	Nostalgia --- Beauty / Joy
Doch feine Glocken dringen auf sie ein.	Nostalgia --- Beauty / Joy

In Rummelplätzen, wo Athleten ringen,	Nostalgia --- Beauty / Joy
Wird alles dunkler schon und ungenau.	Nostalgia --- Beauty / Joy
Ein Leierkasten heult und Küchenmädchen singen.	Nostalgia --- Beauty / Joy
Ein Mann zertrümmert eine morsche Frau.	Uneasiness


Erinnerung aus Krähwinkels Schreckenstagen

Wir Bürgermeister und Senat,	Suspense
Wir haben folgendes Mandat	Suspense
Stadtväterlichst an alle Klassen	Suspense
Der treuen Bürgerschaft erlassen.	Suspense

Ausländer, Fremde, sind es meist,	Annoyance
Die unter uns gesät den Geist	Annoyance
Der Rebellion. Dergleichen Sünder,	Annoyance
Gottlob! sind selten Landeskinder.	Annoyance

Auch Gottesleugner sind es meist;	Annoyance
Wer sich von seinem Gotte reißt,	Annoyance
Wird endlich auch abtrünnig werden	Annoyance
Von seinen irdischen Behörden.	Annoyance

Der Obrigkeit gehorchen, ist	Annoyance
Die erste Pflicht für Jud und Christ.	Annoyance
Es schließe jeder seine Bude	Annoyance
Sobald es dunkelt, Christ und Jude.	Annoyance

Wo ihrer drei beisammen stehn,	Annoyance
Da soll man auseinander gehn.	Annoyance
Des Nachts soll niemand auf den Gassen	Annoyance
Sich ohne Leuchte sehen lassen.	Annoyance

Es liefre seine Waffen aus	Annoyance
Ein jeder in dem Gildenhaus;	Annoyance
Auch Munition von jeder Sorte	Annoyance
Wird deponiert am selben Orte.	Annoyance

Wer auf der Straße räsoniert,	Annoyance --- Humor
Wird unverzüglich füsiliert;	Annoyance --- Humor
Das Räsonieren durch Gebärden	Annoyance --- Humor
Soll gleichfalls hart bestrafet werden.	Annoyance --- Humor

Vertrauet Eurem Magistrat,	Annoyance --- Humor
Der fromm und liebend schützt den Staat	Annoyance --- Humor
Durch huldreich hochwohlweises Walten;	Annoyance --- Humor
Euch ziemt es, stets das Maul zu halten.	Annoyance --- Humor


Ganymed

Wie im Morgenglanze	Beauty / Joy
du rings mich anglühst,	Beauty / Joy
Frühling, Geliebter!	Beauty / Joy
Mit tausendfacher Liebeswonne	Beauty / Joy
sich an mein Herz drängt	Beauty / Joy
deiner ewigen Wärme	Beauty / Joy
heilig Gefühl,	Beauty / Joy
unendliche Schöne!	Beauty / Joy

Daß ich dich fassen möcht'	Vitality
in diesen Arm!	Vitality
Ich komm'! Ich komme!	Vitality
Wohin? Ach, wohin?	Vitality

Hinauf! Hinauf strebt's.	Vitality
Es schweben die Wolken	Vitality
abwärts, die Wolken	Vitality
neigen sich der sehnenden Liebe.	Vitality
Mir! Mir!	Vitality
In euerm Schoße	Vitality
aufwärts!	Vitality
Umfangend umfangen!	Vitality
Aufwärts an deinen Busen,	Vitality
alliebender Vater!	Vitality

Ach, an deinem Busen	Beauty / Joy
lieg' ich, schmachte,	Beauty / Joy
und deine Blumen, dein Gras	Beauty / Joy
drängen sich an mein Herz.	Beauty / Joy
Du kühlst den brennenden	Beauty / Joy
Durst meines Busens,	Beauty / Joy
lieblicher Morgenwind,	Beauty / Joy
ruft drein die Nachtigall	Beauty / Joy
liebend nach mir aus dem Nebeltal.	Beauty / Joy


Die zwei Gesellen

Es zogen zwei rüstge Gesellen	Vitality
Zum erstenmal von Haus,	Vitality
So jubelnd recht in die hellen,	Vitality
Klingenden, singenden Wellen	Vitality
Des vollen Frühlings hinaus.	Vitality

Die strebten nach hohen Dingen,	Beauty / Joy
Die wollten, trotz Lust und Schmerz,	Beauty / Joy
Was Rechts in der Welt vollbringen,	Beauty / Joy
Und wem sie vorübergingen,	Beauty / Joy
Dem lachten Sinn und Herz. -	Beauty / Joy

Der erste, der fand ein Liebchen,	Beauty / Joy
Die Schwieger kauft´ Hof und Haus;	Beauty / Joy
Der wiegte gar bald ein Bübchen,	Beauty / Joy
Und sah aus heimlichem Stübchen	Beauty / Joy
Behaglich ins Feld hinaus.	Beauty / Joy

Dem zweiten sangen und logen	Uneasiness
Die tausend Stimmen im Grund,	Uneasiness
Verlockend´ Sirenen, und zogen	Uneasiness
Ihn in der buhlenden Wogen	Uneasiness
Farbig klingenden Schlund.	Uneasiness

Und wie er auftaucht vom Schlunde,	Sadness
Da war er müde und alt,	Sadness
Sein Schifflein das lag im Grunde,	Sadness
So still wars rings in der Runde,	Sadness
Und über die Wasser wehts kalt.	Sadness

Es singen und klingen die Wellen	Beauty / Joy
Des Frühlings wohl über mir;	Beauty / Joy
Und seh ich so kecke Gesellen,	Nostalgia --- Sadness
Die Tränen im Auge mir schwellen -	Nostalgia --- Sadness
Ach Gott, führ mich liebreich zu Dir!	Nostalgia --- Sadness


Fabrikstraße Tags

Nichts als Mauern. Ohne Gras und Glas	Sadness
zieht die Straße den gescheckten Gurt	Sadness
der Fassaden. Keine Bahnspur surrt.	Sadness
Immer glänzt das Pflaster wassernass.	Sadness

Streift ein Mensch dich, trifft sein Blick dich kalt	Uneasiness
bis ins Mark; die harten Schritte haun	Uneasiness
Feuer aus dem turmhoch steilen Zaun,	Uneasiness
noch sein kurzer Atem wolkt geballt.	Uneasiness

Keine Zuchthauszelle klemmt	Uneasiness --- Awe / Sublime
so in Eis das Denken wie dies Gehn	Uneasiness --- Awe / Sublime
zwischen Mauern, die nur sich besehn.	Uneasiness --- Awe / Sublime

Trägst Du Purpur oder Büßerhemd -:	Awe / Sublime
immer drückt mit riesigem Gewicht	Awe / Sublime
Gottes Bannfluch: uhrenlose Schicht.	Awe / Sublime


Umbra Vitae / Die Menschen stehen vorwärts in den Straßen

Die Menschen stehen vorwärts in den Straßen	Suspense
Und sehen auf die großen Himmelszeichen,	Suspense
Wo die Kometen mit den Feuernasen	Uneasiness
Um die gezackten Türme drohend schleichen.	Uneasiness

Und alle Dächer sind voll Sternedeuter,	Beauty / Joy
Die in den Himmel stecken große Röhren.	Beauty / Joy
Und Zaubrer, wachsend aus den Bodenlöchern,	Beauty / Joy
In Dunkel schräg, die einen Stern beschwören.	Beauty / Joy

Krankheit und Mißwachs durch die Tore kriechen	Uneasiness
In schwarzen Tüchern. Und die Betten tragen	Uneasiness
Das Wälzen und das Jammern vieler Siechen,	Uneasiness
Und welche rennen mit den Totenschragen.	Uneasiness

Selbstmörder gehen nachts in großen Horden,	Sadness
Die suchen vor sich ihr verlornes Wesen,	Sadness
Gebückt in Süd und West, und Ost und Norden,	Sadness
Den Staub zerfegend mit den Armen-Besen.	Sadness

Sie sind wie Staub, der hält noch eine Weile,	Sadness
Die Haare fallen schon auf ihren Wegen,	Sadness
Sie springen, daß sie sterben, 'nun' in Eile,	Sadness
Und sind mit totem Haupt im Feld gelegen.	Sadness

Noch manchmal zappelnd. Und der Felder Tiere	Uneasiness
Stehn um sie blind, und stoßen mit dem Horne	Uneasiness
In ihren Bauch. Sie strecken alle viere	Uneasiness
Begraben unter Salbei und dem Dorne.	Uneasiness

Das Jahr ist tot und leer von seinen Winden,	Sadness
Das wie ein Mantel hängt voll Wassertriefen,	Sadness
Und ewig Wetter, die sich klagend winden	Sadness
Aus Tiefen wolkig wieder zu den Tiefen.]	Sadness

Die Meere aber stocken. In den Wogen	Sadness
Die Schiffe hängen modernd und verdrossen,	Sadness
Zerstreut, und keine Strömung wird gezogen	Sadness
Und aller Himmel Höfe sind verschlossen.	Sadness

Die Bäume wechseln nicht die Zeiten	Sadness
Und bleiben ewig tot in ihrem Ende	Sadness
Und über die verfallnen Wege spreiten	Sadness
Sie hölzern ihre langen Finger-Hände.	Sadness

Wer stirbt, der setzt sich auf, sich zu erheben,	Awe / Sublime
Und eben hat er noch ein Wort gesprochen.	Awe / Sublime
Auf einmal ist er fort. Wo ist sein Leben?	Awe / Sublime --- Sadness
Und seine Augen sind wie Glas zerbrochen.	Awe / Sublime --- Sadness

Schatten sind viele. Trübe und verborgen.	Sadness
Und Träume, die an stummen Türen schleifen,	Sadness
Und der erwacht, bedrückt von andern Morgen,	Sadness
Muß schweren Schlaf von grauen Lidern streifen.	Sadness


Der frohe Wandersmann

Wem Gott will rechte Gunst erweisen,	Awe / Sublime --- Beauty / Joy
Den schickt er in die weite Welt;	Awe / Sublime --- Beauty / Joy
Dem will er seine Wunder weisen	Awe / Sublime --- Beauty / Joy
In Berg und Wald und Strom und Feld.	Awe / Sublime --- Beauty / Joy

Die Trägen, die zu Hause liegen,	Sadness
Erquicket nicht das Morgenrot,	Sadness
Sie wissen nur von Kinderwiegen,	Sadness
Von Sorgen, Last und Not um Brot.	Sadness

Die Bächlein von den Bergen springen,	Vitality --- Beauty / Joy
Die Lerchen schwirren hoch vor Lust,	Vitality --- Beauty / Joy
Was sollt ich nicht mit ihnen singen	Vitality --- Beauty / Joy
Aus voller Kehl und frischer Brust?	Vitality --- Beauty / Joy

Den lieben Gott lass ich nur walten;	Awe / Sublime --- Beauty / Joy
Der Bächlein, Lerchen, Wald und Feld	Awe / Sublime --- Beauty / Joy
Und Erd und Himmel will erhalten,	Awe / Sublime --- Beauty / Joy
Hat auch mein Sach aufs best bestellt!	Awe / Sublime --- Beauty / Joy


Berlin VIII

Schornsteine stehn in großem Zwischenraum	Beauty / Joy
Im Wintertag, und tragen seine Last,	Beauty / Joy
Des schwarzen Himmels dunkelnden Palast.	Beauty / Joy
Wie goldne Stufe brennt sein niedrer Saum.	Beauty / Joy

Fern zwischen kahlen Bäumen, manchem Haus,	Uneasiness
Zäunen und Schuppen, wo die Weltstadt ebbt,	Uneasiness
Und auf vereisten Schienen mühsam schleppt	Uneasiness
Ein langer Güterzug sich schwer hinaus.	Uneasiness

Ein Armenkirchhof ragt, schwarz, Stein an Stein,	Uneasiness
Die Toten schaun den roten Untergang	Uneasiness
Aus ihrem Loch. Er schmeckt wie starker Wein.	Uneasiness

Sie sitzen strickend an der Wand entlang,	Uneasiness
Mützen aus Ruß dem nackten Schläfenbein,	Uneasiness
Zur Marseillaise, dem alten Sturmgesang.	Uneasiness


Herbsttag

Herr, es ist Zeit. Der Sommer war sehr groß.	Vitality --- Awe / Sublime
Leg deinen Schatten auf die Sonnenuhren,	Vitality --- Awe / Sublime
und auf den Fluren lass die Winde los.	Vitality --- Awe / Sublime

Befiehl den letzten Früchten, voll zu sein;	Vitality --- Awe / Sublime
gib ihnen noch zwei südlichere Tage,	Vitality --- Awe / Sublime
dränge sie zur Vollendung hin, und jage	Vitality --- Awe / Sublime
die letzte Süße in den schweren Wein.	Vitality --- Awe / Sublime

Wer jetzt kein Haus hat, baut sich keines mehr.	Sadness
Wer jetzt allein ist, wird es lange bleiben,	Sadness
wird wachen, lesen, lange Briefe schreiben	Nostalgia --- Sadness
und wird in den Alleen hin und her	Nostalgia --- Sadness
unruhig wandern, wenn die Blätter treiben.	Nostalgia --- Sadness


Prometheus / Bedecke deinen Himmel, Zeus

Bedecke deinen Himmel, Zeus,	Beauty / Joy --- Suspense
Mit Wolkendunst!	Beauty / Joy --- Suspense
Und übe, Knaben gleich,	Beauty / Joy --- Suspense
Der Disteln köpft,	Beauty / Joy --- Suspense
An Eichen dich und Bergeshöh'n!	Beauty / Joy --- Suspense
Mußt mir meine Erde	Beauty / Joy --- Suspense
Doch lassen steh'n,	Beauty / Joy --- Suspense
Und meine Hütte,	Beauty / Joy --- Suspense
Die du nicht gebaut,	Beauty / Joy --- Suspense
Und meinen Herd,	Beauty / Joy --- Suspense
Um dessen Glut	Beauty / Joy --- Suspense
Du mich beneidest.	Beauty / Joy --- Suspense

Ich kenne nichts Ärmeres	Annoyance
Unter der Sonn' als euch Götter!	Annoyance
Ihr nähret kümmerlich	Annoyance
Von Opfersteuern	Annoyance
Und Gebetshauch	Annoyance
Eure Majestät	Annoyance
Und darbtet, wären	Annoyance
Nicht Kinder und Bettler	Annoyance
Hoffnungsvolle Toren.	Annoyance

Da ich ein Kind war,	Nostalgia --- Beauty / Joy
Nicht wußte, wo aus, wo ein,	Nostalgia --- Beauty / Joy
Kehrt' ich mein verirrtes Auge	Nostalgia --- Beauty / Joy
Zur Sonne, als wenn drüber wär	Nostalgia --- Beauty / Joy
Ein Ohr zu hören meine Klage,	Nostalgia --- Beauty / Joy
Ein Herz wie meins,	Nostalgia --- Beauty / Joy
Sich des Bedrängten zu erbarmen.	Nostalgia --- Beauty / Joy

Wer half mir	Annoyance --- Vitality
Wider der Titanen Übermut?	Annoyance --- Vitality
Wer rettete vom Tode mich,	Annoyance --- Vitality
Von Sklaverei?	Annoyance --- Vitality
Hast du's nicht alles selbst vollendet,	Annoyance --- Vitality
Heilig glühend Herz?	Annoyance --- Vitality
Und glühtest, jung und gut,	Annoyance --- Vitality
Betrogen, Rettungsdank	Annoyance --- Vitality
Dem Schlafenden dadroben?	Annoyance --- Vitality

Ich dich ehren? Wofür?	Annoyance --- Vitality
Hast du die Schmerzen gelindert	Annoyance --- Vitality
Je des Beladenen?	Annoyance --- Vitality
Hast du die Tränen gestillet	Annoyance --- Vitality
Je des Geängsteten?	Annoyance --- Vitality
Hat nicht mich zum Manne geschmiedet	Vitality --- Awe / Sublime
Die allmächtige Zeit	Vitality --- Awe / Sublime
Und das ewige Schicksal,	Vitality --- Awe / Sublime
Meine Herren und deine?	Vitality --- Awe / Sublime

Wähntest du etwa,	Vitality
Ich sollte das Leben hassen,	Vitality
In Wüsten fliehn,	Vitality
Weil nicht alle Knabenmorgen-	Vitality
Blütenträume reiften?	Vitality

Hier sitz' ich, forme Menschen	Beauty / Joy --- Awe / Sublime
Nach meinem Bilde,	Beauty / Joy --- Awe / Sublime
Ein Geschlecht, das mir gleich sei,	Beauty / Joy --- Awe / Sublime
Zu leiden, weinen,	Beauty / Joy --- Awe / Sublime
Genießen und zu freuen sich,	Beauty / Joy --- Awe / Sublime
Und dein nicht zu achten,	Beauty / Joy --- Awe / Sublime
Wie ich!	Beauty / Joy --- Awe / Sublime


Untreu

Dein Lächeln weint in meiner Brust	Sadness
Die glutverbissnen Lippen eisen	Sadness
Im Atem wittert Laubgewelk!	Sadness
Dein Blick versargt	Sadness
Und	Sadness
Hastet polternd Worte drauf.	Sadness
Vergessen	Sadness
Bröckeln nach die Hände!	Sadness
Frei	Sadness
Buhlt dein Kleidsaum	Sadness
Schlenkrig	Sadness
Drüber rüber!	Sadness


Carpe diem

Ich empfinde fast ein Grauen,	Suspense
dass ich, Plato, für und für	Suspense
bin gesessen über dir.	Suspense
Es ist Zeit hinauszuschauen	Vitality
und sich bei den frischen Quellen	Vitality
in dem Grünen zu ergehn.	Vitality
wo die schönen Blumen stehn	Vitality
und die Fischer Netze stellen!	Vitality

Wozu dienet das Studieren	Sadness
als zu lauter Ungemach!	Sadness
Unterdessen läuft die Bach	Sadness
unsers Lebens, das wir führen,	Sadness
ehe wir es inne werden,	Sadness
auf ihr letztes Ende hin:	Sadness
dann kömmt ohne Geist und Sinn	Sadness
dieses alles in die Erden.	Sadness

Holla, Junger, geh und frage,	Vitality
wo der beste Trunk mag sein,	Vitality
nimm den Krug und fülle Wein!	Vitality
Alles Trauren, Leid und Klage,	Vitality
wie wir Menschen täglich haben,	Vitality
eh uns Clotho fortgerafft,	Vitality
will ich in den süssen Saft,	Vitality
den die Traube gibt, vergraben.	Vitality

Kaufe gleichfalls auch Melonen	Humor
und vergiss des Zuckers nicht,	Humor
schaue nur, dass nichts gebricht!	Humor
Jener mag der Heller schonen,	Humor
der bei seinem Gold und Schätzen	Humor
tolle sich zu kränken pflegt	Humor
und nicht satt zu Bette legt;	Humor
ich will, weil ich kann, mich letzen!	Humor

Bitte meine guten Brüder	Vitality
auf die Musik und ein Glas!	Vitality
Kein Ding schickt sich, dünkt mich, bass	Vitality
als gut Trank und gute Lieder.	Vitality
Lass ich gleich nicht viel zu erben,	Vitality --- Humor
ei, so hab ich edlen Wein!	Vitality --- Humor
Will mit andern lustig sein,	Vitality --- Humor
muss ich gleich alleine sterben.	Vitality --- Humor


Im Winter

Der Winter ist ein rechter Mann,	Humor
kernfest und auf die Dauer;	Humor
sein Fleisch fühlt sich wie Eisen an.	Humor
Er scheut nicht süß noch sauer.	Humor

Er zieht sein Hemd im Freien an	Humor
Und läßt‘s vorher nicht wärmen,	Humor
Und spottet über Fluß im	Humor
Und Kolik in Gedärmen.	Humor

Aus Blumen und aus Vogelsang	Humor
Weiß er sich nichts zu machen,	Humor
Haßt warmen Drang und warmen Klang	Humor
Und alle warmen Sachen.	Humor

Doch wenn die Füchse bellen sehr,	Uneasiness
Wenn‘s Holz im Ofen knittert,	Uneasiness
Und an dem Ofen Knecht und Herr	Uneasiness
Die Hände reibt und zittert,	Uneasiness

Wenn Stein und Bein vor Frost zerbricht	Uneasiness
und Teich und Seen krachen;	Uneasiness
das klingt ihm gut, das haßt er nicht,	Humor
dann will er sich totlachen.	Humor

Sein Schloß von Eis liegt ganz hinaus	Humor
beim Nordpol an dem Strande;	Humor
doch hat er auch ein Sommerhaus	Humor
im lieben Schweizerlande.	Humor

Da ist er denn bald dort bald hier,	Humor
gut Regiment zu führen,	Humor
und wenn er durchzieht stehn wir	Humor
und sehn ihn an und frieren.	Humor


Kriegslied

Sengen, brennen, schießen, stechen,	Uneasiness
Schädel spalten, Rippen brechen,	Uneasiness
spionieren, requirieren,	Uneasiness
patrouillieren, exerzieren,	Uneasiness
fluchen, bluten, hungern, frieren ...	Uneasiness
So lebt der edle Kriegerstand,	Annoyance
die Flinte in der linken Hand,	Annoyance
das Messer in der rechten Hand –	Annoyance
mit Gott, mit Gott, mit Gott,	Annoyance
mit Gott für König und Vaterland.	Annoyance

Aus dem Bett von Lehm und Jauche	Uneasiness
zur Attacke auf dem Bauche!	Uneasiness
Trommelfeuer – Handgranaten –	Annoyance --- Uneasiness
Wunden – Leichen – Heldentaten –	Annoyance --- Uneasiness
bravo, tapfere Soldaten!	Annoyance
So lebt der edle Kriegerstand,	Annoyance
das Eisenkreuz am Preußenband,	Annoyance
die Tapferkeit am Bayernband,	Annoyance
mit Gott, mit Gott, mit Gott,	Annoyance
mit Gott für König und Vaterland.	Annoyance

Stillgestanden! Hoch die Beine!	Annoyance
Augen gradeaus, ihr Schweine!	Annoyance
Visitiert und schlecht befunden.	Annoyance
Keinen Urlaub. Angebunden.	Annoyance
Strafdienst extra sieben Stunden.	Annoyance
So lebt der edle Kriegerstand.	Annoyance
Jawohl, Herr Oberleutenant!	Annoyance
Und zu Befehl, Herr Leutenant!	Annoyance
Mit Gott, mit Gott, mit Gott,	Annoyance
mit Gott für König und Vaterland.	Annoyance

Vorwärts mit Tabak und Kümmel!	Annoyance
Bajonette. Schlachtgetümmel.	Annoyance
Vorwärts! Sterben oder Siegen!	Annoyance
Deutscher kennt kein Unterliegen.	Annoyance
Knochen splittern, Fetzen fliegen.	Annoyance
So lebt der edle Kriegerstand.	Annoyance
Der Schweiß tropft in den Grabenrand,	Annoyance --- Uneasiness
das Blut tropft in den Straßenrand,	Annoyance --- Uneasiness
mit Gott, mit Gott, mit Gott,	Annoyance
mit Gott für König und Vaterland.	Annoyance

Angeschossen – hochgeschmissen –	Annoyance --- Uneasiness
Bauch und Därme aufgerissen.	Annoyance --- Uneasiness
Rote Häuser – blauer Äther –	Annoyance
Teufel! Alle heiligen Väter! ...	Annoyance
Mutter! Mutter!! Sanitäter!!!	Annoyance
So stirbt der edle Kriegerstand,	Annoyance
in Stiefel, Maul und Ohren Sand	Annoyance
und auf das Grab drei Schippen Sand –	Annoyance
mit Gott, mit Gott, mit Gott,	Annoyance
mit Gott für König und Vaterland.	Annoyance


Auf meinen bestürmeten Lebens-Lauff

Wie sehr der Wirbelstrom so vieler Angst und plagen	Beauty / Joy
mich drähet um und um / so bistu doch mein Hort	Beauty / Joy
mein mittel punct / in dem mein Zirkel fort und fort	Beauty / Joy
mein Geist halb hafften bleibt vom sturm unausgeschlagen.	Beauty / Joy

Mein Zünglein stehet stät / von Wellen fort getragen	Beauty / Joy --- Vitality
auf meinen Stern gericht. Mein Herz und Aug′ ist dort	Beauty / Joy --- Vitality
es wartet schon auf mich am Ruhe-vollen Port:	Beauty / Joy --- Vitality
dieweil muß ich mich keck in weh und See hinwagen.	Beauty / Joy --- Vitality

Offt will der Muht / der Mast / zu tausend trümmern springen.	Sadness
Bald thun die Ruder-Knecht / die sinnen / keinen Zug.	Sadness
Bald kan ich keinen Wind in glaubens-Segel bringen.	Sadness

Jetz hab ich / meine Uhr zu richten / keinen fug.	Sadness
Dann wollen mich die Wind auf andre zufahrt dringen,	Sadness
bring′ an den Hafen mich / mein GOtt / es ist genug!	Sadness --- Vitality


Das Hungerlied

Verehrter Herr und König,	Suspense
Weißt du die schlimme Geschicht?	Suspense
Am Montag aßen wir wenig,	Annoyance
Und am Dienstag aßen wir nicht.	Annoyance

Und am Mittwoch mußten wir darben,	Annoyance
Und am Donnerstag litten wir Not;	Annoyance
Und ach, am Freitag starben	Annoyance
Wir fast den Hungertod!	Annoyance

Drum laß am Samstag backen	Humor
Das Brot, fein säuberlich -	Humor
Sonst werden wir sonntags packen	Humor
Und fressen, o König, dich!	Humor


Stadt

Zehntausend starre Blöcke sind im Tal errichtet,	Suspense --- Uneasiness
Aus: Stein auf Stein um Holz- und Eisenroste hochgeschichtet;	Suspense --- Uneasiness
Und Block an Block zu einem Berg gedrückt,	Suspense --- Uneasiness
Von Dampfrohr, Turm und Bahn noch überbrückt,	Suspense --- Uneasiness
Von Draht, der Netz an Netze spinnt.	Suspense --- Uneasiness
Der Berg, von vielen Furchen tief durchwühlt:	Suspense --- Uneasiness
Das ist das große Labyrinth,	Uneasiness --- Awe / Sublime
Dadurch das Schicksal Mensch um Menschen spült.	Uneasiness --- Awe / Sublime

Fünfhunderttausend rollt im Kreis das große Leben	Awe / Sublime
Durch alle Rinnen fort und fort in ungeheurem Streben:	Awe / Sublime
In Kaufhaus, Werkstatt, Saal und Bahnhofshalle,	Awe / Sublime
In Schule, Park, am Promenadenwalle,	Awe / Sublime
Im Fahrstuhlschacht, im Bau am Krahn,	Awe / Sublime
Treppauf und ab, durch Straßen über Plätze,	Awe / Sublime
Auf Wagen, Rad und Straßenbahn:	Awe / Sublime
Da schäumt des Menschenstrudels wirre Hetze.	Awe / Sublime

Fünfhunderttausend Menschen rollt das große Leben	Awe / Sublime
Durch alle Rinnen fort und fort in ungeheurem Streben.	Awe / Sublime
Und karrt der Tod auch Hundert täglich fort,	Awe / Sublime
Es braust der Lärm wie sonst an jedem Ort.	Awe / Sublime
Schleppt er vom Hammer-Block den Schmied,	Awe / Sublime --- Uneasiness
Schleppt er vom Kurven-Gleis den Wagenleiter:	Awe / Sublime --- Uneasiness
Noch stärker brüllt das Straßenlied:	Awe / Sublime --- Uneasiness
Der Wagen fährt - der Hammer dröhnt weiter.	Awe / Sublime --- Uneasiness


An die Parzen

Nur Einen Sommer gönnt, ihr Gewaltigen!	Vitality
Und einen Herbst zu reifem Gesange mir,	Vitality
Daß williger mein Herz, vom süßen	Vitality
Spiele gesättiget, dann mir sterbe.	Vitality

Die Seele, der im Leben ihr göttlich Recht	Sadness --- Awe / Sublime
Nicht ward, sie ruht auch drunten im Orkus nicht;	Sadness --- Awe / Sublime
Doch ist mir einst das Heil'ge, das am	Beauty / Joy
Herzen mir liegt, das Gedicht gelungen,	Beauty / Joy

Willkommen dann, o Stille der Schattenwelt!	Vitality
Zufrieden bin ich, wenn auch mein Saitenspiel	Vitality
Mich nicht hinab geleitet; Einmal	Vitality
Lebt ich, wie Götter, und mehr bedarfs nicht.	Awe / Sublime


Die Stadt

Sehr weit ist diese Nacht. Und Wolkenschein	Beauty / Joy
Zerreißet vor des Mondes Untergang.	Beauty / Joy
Und tausend Fenster stehn die Nacht entlang	Beauty / Joy
Und blinzeln mit den Lidern, rot und klein.	Beauty / Joy

Wie Aderwerk gehn Straßen durch die Stadt,	Sadness
Unzählig Menschen schwemmen aus und ein.	Sadness
Und ewig stumpfer Ton von stumpfem Sein	Sadness
Eintönig kommt heraus in Stille matt.	Sadness

Gebären, Tod, gewirktes Einerlei,	Uneasiness
Lallen der Wehen, langer Sterbeschrei,	Uneasiness
Im blinden Wechsel geht es dumpf vorbei.	Uneasiness

Und Schein und Feuer, Fackeln rot und Brand,	Uneasiness
Die drohn im Weiten mit gezückter Hand	Uneasiness
Und scheinen hoch von dunkler Wolkenwand.	Uneasiness


Vorstadt im Föhn

Am Abend liegt die Stätte öd und braun,	Uneasiness
Die Luft von gräulichem Gestank durchzogen.	Uneasiness
Das Donnern eines Zugs vom Brückenbogen -	Uneasiness
Und Spatzen flattern über Busch und Zaun.	Uneasiness

Geduckte Hütten, Pfade wirr verstreut,	Uneasiness --- Suspense
In Gärten Durcheinander und Bewegung,	Uneasiness --- Suspense
Bisweilen schwillt Geheul aus dumpfer Regung,	Uneasiness --- Suspense
In einer Kinderschar fliegt rot ein Kleid.	Uneasiness --- Suspense

Am Kehricht pfeift verliebt ein Rattenchor.	Uneasiness
In Körben tragen Frauen Eingeweide,	Uneasiness
Ein ekelhafter Zug voll Schmutz und Räude,	Uneasiness
Kommen sie aus der Dämmerung hervor.	Uneasiness

Und ein Kanal speit plötzlich feistes Blut	Uneasiness
Vom Schlachthaus in den stillen Fluß hinunter.	Uneasiness
Die Föhne färben karge Stauden bunter,	Uneasiness
Und langsam kriecht die Röte durch die Flut.	Uneasiness

Ein Flüstern, das in trübem Schlaf ertrinkt.	Uneasiness
Gebilde gaukeln auf aus Wassergräben,	Uneasiness
Vielleicht Erinnerung an ein früheres Leben,	Nostalgia --- Beauty / Joy
Die mit den warmen Winden steigt und sinkt.	Nostalgia --- Beauty / Joy

Aus Wolken tauchen schimmernde Alleen,	Beauty / Joy
Erfüllt von schönen Wägen, kühnen Reitern.	Beauty / Joy
Dann sieht man auch ein Schiff auf Klippen scheitern	Beauty / Joy
Und manchmal rosenfarbene Moscheen.	Beauty / Joy


Sehnsucht / Es schienen so golden die Sterne

Es schienen so golden die Sterne,	Nostalgia --- Beauty / Joy
Am Fenster ich einsam stand	Nostalgia --- Beauty / Joy
Und hörte aus weiter Ferne	Nostalgia --- Beauty / Joy
Ein Posthorn im stillen Land.	Nostalgia --- Beauty / Joy
Das Herz mir im Leib entbrennte,	Nostalgia --- Beauty / Joy
Da hab ich mir heimlich gedacht:	Nostalgia --- Beauty / Joy
Ach, wer da mitreisen könnte	Nostalgia --- Beauty / Joy
In der prächtigen Sommernacht!	Nostalgia --- Beauty / Joy

Zwei junge Gesellen gingen	Beauty / Joy
Vorüber am Bergeshang,	Beauty / Joy
Ich hörte im Wandern sie singen	Beauty / Joy
Die stille Gegend entlang:	Beauty / Joy
Von schwindelnden Felsenschlüften,	Nostalgia --- Beauty / Joy
Wo die Wälder rauschen so sacht,	Nostalgia --- Beauty / Joy
Von Quellen, die von den Klüften	Nostalgia --- Beauty / Joy
Sich stürzen in die Waldesnacht.	Nostalgia --- Beauty / Joy

Sie sangen von Marmorbildern,	Nostalgia --- Beauty / Joy
Von Gärten, die überm Gestein	Nostalgia --- Beauty / Joy
In dämmernden Lauben verwildern,	Nostalgia --- Beauty / Joy
Palästen im Mondenschein,	Nostalgia --- Beauty / Joy
Wo die Mädchen am Fenster lauschen,	Nostalgia --- Beauty / Joy
Wann der Lauten Klang erwacht	Nostalgia --- Beauty / Joy
Und die Brunnen verschlafen rauschen	Nostalgia --- Beauty / Joy
In der prächtigen Sommernacht. -	Nostalgia --- Beauty / Joy


Punkt

Die wüsten Straßen fließen lichterloh	Uneasiness
durch den erloschnen Kopf. Und tun mir weh.	Uneasiness
Ich fühle deutlich, daß ich bald vergeh -	Uneasiness --- Sadness
Dornrosen meines Fleisches, stecht nicht so.	Uneasiness --- Sadness

Die Nacht verschimmelt. Giftlaternenschein	Uneasiness
Hat, kriechend, sie mit grünem Dreck beschmiert.	Uneasiness
Das Herz ist wie ein Sack. Das Blut erfriert.	Uneasiness
Die Welt fällt um. Die Augen stürzen ein.	Uneasiness


An eine, die vorüberging

Der Straßenlärm betäubend zu mir drang.	Sadness
In großer Trauer, schlank, von Schmerz gestrafft,	Sadness
Schritt eine Frau vorbei, die mit der Hand gerafft,	Beauty / Joy
Den Saum des Kleides hob, der glockig schwang.	Beauty / Joy

Anmutig, wie gemeißelt war das Bein.	Beauty / Joy
Und ich, erstarrt, wie außer mich gebracht,	Beauty / Joy
Vom Himmel ihrer Augen, wo ein Sturm erwacht,	Beauty / Joy
Sog Süße, die betört, und Lust, die tötet, ein.	Beauty / Joy

Ein Blitz… dann Nacht! - Du Schöne, mir verloren,	Sadness
Durch deren Blick ich jählings neu geboren,	Sadness
Werd ich in Ewigkeit dich erst wiedersehn?	Sadness

Woanders, weit von hier! zu spät! soll’s nie geschehn?	Sadness
Dein Ziel ist mir und dir das meine unbekannt.	Sadness
Dich hätte ich geliebt, und du hast es geahnt!	Sadness


Es ist alles eitel / Alles ist eitel

Du siehst, wohin du siehst nur  Eitelkeit auf Erden.	Sadness --- Awe / Sublime
Was dieser heute baut, reißt jener morgen ein:	Sadness --- Awe / Sublime
Wo itzund Städte stehn, wird eine Wiese sein	Sadness --- Awe / Sublime
Auf der ein Schäferskind wird spielen mit den Herden:	Sadness --- Awe / Sublime

Was itzund prächtig blüht, soll bald zertreten werden.	Sadness --- Awe / Sublime
Was itzt so pocht und trotzt ist Morgen Asch und Bein	Sadness --- Awe / Sublime
Nichts ist, das ewig sei, kein Erz, kein Marmorstein.	Awe / Sublime --- Sadness
Itzt lacht das Glück uns an, bald donnern die Beschwerden.	Awe / Sublime --- Sadness

Der hohen Taten Ruhm muß wie ein Traum vergehn.	Awe / Sublime --- Sadness
Soll denn das Spiel der Zeit, der leichte Mensch bestehn?	Awe / Sublime --- Sadness
Ach! was ist alles dies, was wir für köstlich achten,	Awe / Sublime --- Sadness

Als schlechte Nichtigkeit, als Schatten, Staub und Wind;	Awe / Sublime --- Sadness
Als eine Wiesenblum, die man nicht wiederfind't.	Awe / Sublime --- Sadness
Noch will was ewig ist kein einig Mensch betrachten!	Awe / Sublime --- Sadness


Verfall

Am Abend, wenn die Glocken Frieden läuten,	Beauty / Joy
Folg ich der Vögel wundervollen Flügen,	Beauty / Joy
Die lang geschart, gleich frommen Pilgerzügen,	Beauty / Joy
Entschwinden in den herbstlich klaren Weiten.	Beauty / Joy

Hinwandelnd durch den dämmervollen Garten	Nostalgia --- Beauty / Joy
Träum ich nach ihren helleren Geschicken	Nostalgia --- Beauty / Joy
Und fühl der Stunden Weiser kaum mehr rücken.	Nostalgia --- Beauty / Joy
So folg ich über Wolken ihren Fahrten.	Nostalgia --- Beauty / Joy

Da macht ein Hauch mich von Verfall erzittern.	Uneasiness
Die Amsel klagt in den entlaubten Zweigen.	Uneasiness
Es schwankt der rote Wein an rostigen Gittern,	Uneasiness

Indes wie blasser Kinder Todesreigen	Uneasiness
Um dunkle Brunnenränder, die verwittern,	Uneasiness
Im Wind sich fröstelnd blaue Astern neigen.	Uneasiness


Das Göttliche

Edel sei der Mensch	Beauty / Joy
Hilfreich und gut!	Beauty / Joy
Denn das allein	Beauty / Joy
Unterscheidet ihn	Beauty / Joy
Von allen Wesen,	Beauty / Joy
Die wir kennen.	Beauty / Joy

Heil den unbekannten	Beauty / Joy
Höhern Wesen	Beauty / Joy
Die wir ahnen!	Beauty / Joy
Ihnen gleiche der Mensch!	Beauty / Joy
Sein Beispiel lehr uns	Beauty / Joy
Jene glauben.	Beauty / Joy

Denn unfühlend	Awe / Sublime
Ist die Natur:	Awe / Sublime
Es leuchtet die Sonne	Awe / Sublime
Über Bös und Gute	Awe / Sublime
Und dem Verbrecher	Awe / Sublime
Glänzen wie dem Besten	Awe / Sublime
der Mond und die Sterne.	Awe / Sublime

Wind und Ströme,	Awe / Sublime
Donner und Hagel	Awe / Sublime
Rauschen ihren Weg	Awe / Sublime
Und ergreifen	Awe / Sublime
Vorüber eilend	Awe / Sublime
Einen um den andern.	Awe / Sublime

Auchso das Glück	Awe / Sublime
Tappt unter die Menge,	Awe / Sublime
Faßt bald des Knaben	Awe / Sublime
Lockige Unschuld,	Awe / Sublime
Bald auch den kahlen	Awe / Sublime
Schuldigen Scheitel.	Awe / Sublime

Nach ewigen, ehrnen,	Awe / Sublime
Großen Gesetzen	Awe / Sublime
Müssen wir alle	Awe / Sublime
Unseres Daseins	Awe / Sublime
Kreise vollenden.	Awe / Sublime

Nur allein der Mensch	Awe / Sublime --- Vitality
Vermag das Unmögliche:	Awe / Sublime --- Vitality
Er unterscheidet,	Awe / Sublime --- Vitality
Wählet und richtet;	Awe / Sublime --- Vitality
Er kann dem Augenblick	Awe / Sublime --- Vitality
Dauer verleihen.	Awe / Sublime --- Vitality

Er allein darf	Awe / Sublime
Den Guten lohnen,	Awe / Sublime
Den Bösen strafen,	Awe / Sublime
Heilen und retten,	Awe / Sublime
Alles Irrende, Schweifende	Awe / Sublime
Nützlich verbinden.	Awe / Sublime

Und wir verehren	Awe / Sublime
Die Unsterblichen,	Awe / Sublime
Als wären sie Menschen,	Awe / Sublime
Täten im großen,	Awe / Sublime
Was der Beste im kleinen	Awe / Sublime
tut oder möchte.	Awe / Sublime

Der edle Mensch	Vitality
Sei hilfreich und gut!	Vitality
Unermüdet schaff er	Vitality
Das Nützliche, Rechte,	Vitality
Sei uns ein Vorbild	Vitality
Jener geahneten Wesen.	Vitality


Abendlied / Der Mond ist aufgegangen

Der Mond ist aufgegangen,	Beauty / Joy
Die goldnen Sternlein prangen	Beauty / Joy
Am Himmel hell und klar;	Beauty / Joy
Der Wald steht schwarz und schweiget,	Beauty / Joy
Und aus den Wiesen steiget	Beauty / Joy
Der weiße Nebel wunderbar.	Beauty / Joy

Wie ist die Welt so stille,	Beauty / Joy
Und in der Dämmrung Hülle	Beauty / Joy
So traulich und so hold!	Beauty / Joy
Als eine stille Kammer,	Beauty / Joy
Wo ihr des Tages Jammer	Beauty / Joy
Verschlafen und vergessen sollt.	Beauty / Joy

Seht ihr den Mond dort stehen?	Beauty / Joy
Er ist nur halb zu sehen,	Beauty / Joy
Und ist doch rund und schön!	Beauty / Joy
So sind wohl manche Sachen,	Awe / Sublime
Die wir getrost belachen,	Awe / Sublime
Weil unsre Augen sie nicht sehn.	Awe / Sublime

Wir stolze Menschenkinder	Awe / Sublime
Sind eitel arme Sünder	Awe / Sublime
Und wissen gar nicht viel;	Awe / Sublime
Wir spinnen Luftgespinste	Awe / Sublime
Und suchen viele Künste	Awe / Sublime
Und kommen weiter von dem Ziel.	Awe / Sublime

Gott, laß uns dein Heil schauen,	Awe / Sublime --- Vitality
Auf nichts Vergänglichs trauen,	Awe / Sublime --- Vitality
Nicht Eitelkeit uns freun!	Awe / Sublime --- Vitality
Laß uns einfältig werden	Awe / Sublime --- Vitality
Und vor dir hier auf Erden	Awe / Sublime --- Vitality
Wie Kinder fromm und fröhlich sein!	Awe / Sublime --- Vitality

Wollst endlich sonder Grämen	Awe / Sublime --- Vitality
Aus dieser Welt uns nehmen	Awe / Sublime --- Vitality
Durch einen sanften Tod!	Awe / Sublime --- Vitality
Und, wenn du uns genommen,	Awe / Sublime --- Vitality
Laß uns in Himmel kommen,	Awe / Sublime --- Vitality
Du unser Herr und unser Gott!	Awe / Sublime --- Vitality

So legt euch denn, ihr Brüder,	Vitality --- Awe / Sublime
In Gottes Namen nieder;	Vitality --- Awe / Sublime
Kalt ist der Abendhauch.	Vitality --- Awe / Sublime
Verschon uns, Gott! mit Strafen,	Vitality --- Awe / Sublime
Und laß uns ruhig schlafen!	Vitality --- Awe / Sublime
Und unsern kranken Nachbar auch!	Vitality --- Awe / Sublime


Ach Liebste lass uns eilen

Ach Liebste, laß uns eilen,	Vitality
Wir haben Zeit,	Vitality
Es schadet uns verweilen	Vitality
Uns beyderseit.	Vitality

Der edlen Schönheit Gaben	Sadness
Fliehen Fuß für Fuß,	Sadness
Daß alles, was wir haben,	Sadness
Verschwinden muß.	Sadness

Der Wangen Ziehr verbleichet,	Sadness
Das Haar wird greiß,	Sadness
Der Augen Feuer weichet,	Sadness
Die Brunst wird Eiß.	Sadness

Das Mündlein von Corallen	Sadness
Wird ungestalt,	Sadness
Die Händ' als Schnee verfallen,	Sadness
Und du wirst alt.	Sadness

Drumb laß uns jetzt geniessen	Vitality
Der Jugend Frucht,	Vitality
Eh' als wir folgen müssen	Vitality --- Sadness
Der Jahre Flucht.	Vitality --- Sadness

Wo du dich selber liebest,	Beauty / Joy
So liebe mich,	Beauty / Joy
Gieb mir das, wann du giebest,	Beauty / Joy
Verlier auch ich.	Beauty / Joy


Künstlers Abendlied

Ach, daß die inn're Schöpfungskraft	Vitality
Durch meinen Sinn erschölle!	Vitality
Daß eine Bildung voller Saft	Vitality
Aus meinen Fingern quölle!	Vitality

Ich zittre nur, ich stottre nur	Vitality
Und kann es doch nicht lassen;	Vitality
Ich fühl', ich kenne dich, Natur,	Vitality
Und so muß ich dich fassen.	Vitality

Bedenk' ich dann, wie manches Jahr	Nostalgia --- Beauty / Joy
Sich schon mein Sinn erschließet,	Nostalgia --- Beauty / Joy
Wie er, wo dürre Heide war,	Nostalgia --- Beauty / Joy
Nun Freudenquell genießet:	Nostalgia --- Beauty / Joy

Wie sehn' ich mich, Natur, nach dir,	Beauty / Joy
Dich treu und lieb zu fühlen!	Beauty / Joy
Ein lust'ger Springbrunn, wirst du mir	Beauty / Joy
Aus tausend Röhren spielen.	Beauty / Joy

Wirst alle meine Kräfte mir	Beauty / Joy
In meinem Sinn erheitern,	Beauty / Joy
Und dieses enge Dasein hier	Beauty / Joy
Zur Ewigkeit erweitern.	Beauty / Joy


Wiegenlied

Deutschland - auf weichem Pfühle	Humor
Mach' dir den Kopf nicht schwer!	Humor
Im irdischen Gewühle	Humor
Schlafe, was willst du mehr?	Humor

Laß jede Freiheit dir rauben,	Annoyance --- Humor
Setze dich nicht zur Wehr,	Annoyance --- Humor
Du behältst ja den christlichen Glauben:	Humor --- Annoyance
Schlafe, was willst du mehr?	Humor --- Annoyance

Und ob man dir alles verböte,	Humor --- Annoyance
Doch gräme dich nicht zu sehr,	Humor --- Annoyance
Du hast ja Schiller und Goethe:	Humor --- Annoyance
Schlafe, was willst du mehr?	Humor --- Annoyance

Dein König beschützt die Kamele	Annoyance --- Humor
Und macht sie pensionär,	Annoyance --- Humor
Dreihundert Taler die Seele:	Annoyance --- Humor
Schlafe, was willst du mehr?	Annoyance --- Humor

Es fechten dreihundert Blätter	Annoyance --- Humor
Im Schatten, ein Sparterheer;	Annoyance --- Humor
Und täglich erfährst du das Wetter:	Annoyance --- Humor
Schlafe, was willst du mehr?	Annoyance --- Humor

Kein Kind läuft ohne Höschen	Annoyance --- Humor
Am Rhein, dem freien, umher:	Annoyance --- Humor
Mein Deutschland, mein Dornröschen,	Annoyance --- Humor
Schlafe, was willst du mehr?	Annoyance --- Humor


Einsamkeit

In dieser Einsamkeit, der mehr denn öden Wüsten,	Beauty / Joy
Gestreckt auf wildes Kraut, an die bemooste See:	Beauty / Joy
Beschau ich jenes Tal und dieser Felsen Höh',	Beauty / Joy
Auf welchem Eulen nur und stille Vögel nisten.	Beauty / Joy

Hier, fern von dem Palast; weit von des Pöbels Lüsten,	Awe / Sublime
Betracht' ich: wie der Mensch in Eitelkeit vergeh',	Awe / Sublime
Wie, auf nicht festem Grund all unser Hoffen steh',	Awe / Sublime
Wie die vor Abend schmähn, die vor dem Tag uns grüßten.	Awe / Sublime

Die Höll', der rauhe Wald, der Totenkopf, der Stein,	Uneasiness
Den auch die Zeit auffrisst, die abgezehrten Bein'	Uneasiness
Entwerfen in dem Mut unzählige Gedanken.	Uneasiness

Der Mauern alter Graus, dies unbebaute Land	Awe / Sublime
Ist schön und fruchtbar mir, der eigentlich erkannt,	Awe / Sublime
dass alles, ohn' ein' Geist, den Gott selbst hält, muss wanken.	Awe / Sublime


Abschied

O Täler weit, o Höhen,	Vitality
O schöner, grüner Wald,	Vitality
Du meiner Lust und Wehen	Vitality
Andächt'ger Aufenthalt!	Vitality
Da draußen, stets betrogen,	Vitality
Saust die geschäft'ge Welt,	Vitality
Schlag noch einmal die Bogen	Vitality
Um mich, du grünes Zelt!	Vitality

Wenn es beginnt zu tagen,	Beauty / Joy
Die Erde dampft und blinkt,	Beauty / Joy
Die Vögel lustig schlagen,	Beauty / Joy
Daß dir dein Herz erklingt:	Beauty / Joy
Da mag vergehn, verwehen	Beauty / Joy --- Vitality
Das trübe Erdenleid,	Beauty / Joy --- Vitality
Da sollst du auferstehen	Beauty / Joy --- Vitality
In junger Herrlichkeit!	Beauty / Joy --- Vitality

Da steht im Wald geschrieben	Awe / Sublime --- Beauty / Joy
Ein stilles, ernstes Wort	Awe / Sublime --- Beauty / Joy
Von rechtem Tun und Lieben,	Awe / Sublime --- Beauty / Joy
Und was des Menschen Hort.	Awe / Sublime --- Beauty / Joy
Ich habe treu gelesen	Awe / Sublime --- Beauty / Joy
Die Worte, schlicht und wahr,	Awe / Sublime --- Beauty / Joy
Und durch mein ganzes Wesen	Awe / Sublime --- Beauty / Joy
Wards unaussprechlich klar.	Awe / Sublime --- Beauty / Joy

Bald werd ich dich verlassen,	Nostalgia --- Beauty / Joy
Fremd in der Fremde gehn,	Nostalgia --- Beauty / Joy
Auf buntbewegten Gassen	Nostalgia --- Beauty / Joy
Des Lebens Schauspiel sehn;	Nostalgia --- Beauty / Joy
Und mitten in dem Leben	Awe / Sublime
Wird deines Ernsts Gewalt	Awe / Sublime
Mich Einsamen erheben,	Awe / Sublime
So wird mein Herz nicht alt.	Awe / Sublime


Frische Fahrt

Laue Luft kommt blau geflossen,	Vitality --- Beauty / Joy
Frühling, Frühling soll es sein!	Vitality --- Beauty / Joy
Waldwärts Hörnerklang geschossen,	Vitality --- Beauty / Joy
Mutger Augen lichter Schein;	Vitality --- Beauty / Joy
Und das Wirren bunt und bunter	Vitality --- Beauty / Joy
Wird ein magisch wilder Fluß,	Vitality --- Beauty / Joy
In die schöne Welt hinunter	Vitality --- Beauty / Joy
Lockt dich dieses Stromes Gruß.	Vitality --- Beauty / Joy

Und ich mag mich nicht bewahren!	Vitality
Weit von euch treibt mich der Wind,	Vitality
Auf dem Strome will ich fahren,	Vitality
Von dem Glanze selig blind!	Vitality
Tausend Stimmen lockend schlagen,	Vitality
Hoch Aurora flammend weht,	Vitality
Fahre zu! Ich mag nicht fragen,	Vitality
Wo die Fahrt zu Ende geht!	Vitality


Mächtiges Überraschen

Ein Strom entrauscht umwölktem Felsensaale,	Vitality
Dem Ozean sich eilig zu verbinden;	Vitality
Was auch sich spiegeln mag von Grund zu Gründen,	Vitality
Er wandelt unaufhaltsam fort zu Tale.	Vitality

Dämonisch aber stürzt mit einem Male -	Suspense
Ihr folgen Berg und Wald in Wirbelwinden -	Suspense
Sich Oreas, Behagen dort zu finden,	Suspense
Und hemmt den Lauf, begrenzt die weite Schale.	Suspense

Die Welle sprüht, und staunt zurück und weichet,	Vitality
Und schwillt bergan, sich immer selbst zu trinken;	Vitality
Gehemmt ist nun zum Vater hin das Streben.	Vitality

Sie schwankt und ruht, zum See zurückgedeichet;	Vitality
Gestirne, spiegelnd sich, beschau'n das Blinken	Awe / Sublime
Des Wellenschlags am Fels, ein neues Leben.	Awe / Sublime


Der Aufbruch

Einmal schon haben Fanfaren mein ungeduldiges Herz blutig gerissen,	Uneasiness
Dass es, aufsteigend wie ein Pferd, sich wütend ins Gezäum verbissen.	Uneasiness
Damals schlug Tamburmarsch den Sturm auf allen Wegen,	Uneasiness
Und herrlichste Musik der Erde hieß uns Kugelregen.	Uneasiness
Dann, plötzlich, stand Leben stille. Wege führten zwischen alten Bäumen.	Beauty / Joy
Gemächer lockten. Es war süß, zu weilen und sich versäumen,	Beauty / Joy
Von Wirklichkeit den Leib so wie von staubiger Rüstung zu entketten,	Beauty / Joy
Wollüstig sich in Daunen weicher Traumstunden einzubetten.	Beauty / Joy
Aber eines Morgens rollte durch Nebelluft das Echo von Signalen,	Suspense
Hart, scharf, wie Schwerthieb pfeifend. Es war, wie wenn im Dunkel plötzlich Lichter aufstrahlen.	Suspense
Es war, wie wenn durch Biwakfrühe Trompetenstöße klirren,	Suspense
Die Schlafenden aufspringen und die Zelte abschlagen und die Pferde schirren.	Suspense
Ich war in Reihen eingeschient, die in den Morgen stießen, Feuer über Helm und Bügel,	Suspense
Vorwärts, in Blick und Blut die Schlacht, mit vorgehaltnem Zügel.	Suspense
Vielleicht würden uns am Abend Siegesmärsche umstreichen,	Uneasiness
Vielleicht lägen wir irgendwo ausgestreckt unter Leichen.	Uneasiness
Aber vor dem Erraffen und vor dem Versinken	Vitality
Würden unsre Augen sich an Welt und Sonne satt und glühend trinken.	Vitality


Gefunden

Ich ging im Walde	Beauty / Joy
So vor mich hin,	Beauty / Joy
Und nichts zu suchen,	Beauty / Joy
Das war mein Sinn.	Beauty / Joy

Im Schatten sah ich	Beauty / Joy
Ein Blümlein stehn,	Beauty / Joy
Wie Sterne blinkend,	Beauty / Joy
Wie Äuglein schön.	Beauty / Joy

Ich wollt es brechen,	Beauty / Joy
Da sagt' es fein:	Beauty / Joy
Soll ich zum Welken	Beauty / Joy
Gebrochen sein?	Beauty / Joy

Mit allen Wurzeln	Beauty / Joy
Hob ich es aus,	Beauty / Joy
Und trugs zum Garten	Beauty / Joy
Am hübschen Haus.	Beauty / Joy

Ich pflanzt es wieder	Beauty / Joy
Am kühlen Ort;	Beauty / Joy
Nun zweigt und blüht es	Beauty / Joy
Mir immer fort.	Beauty / Joy


Die Beiden

Sie trug den Becher in der Hand -	Suspense --- Beauty / Joy
Ihr Kinn und Mund glich seinem Rand -,	Suspense --- Beauty / Joy
So leicht und sicher war ihr Gang,	Suspense --- Beauty / Joy
Kein Tropfen aus dem Becher sprang.	Suspense --- Beauty / Joy

So leicht und fest war seine Hand:	Suspense
Er ritt auf einem jungen Pferde,	Suspense
Und mit nachlässiger Gebärde	Suspense
Erzwang er, daß es zitternd stand.	Suspense

Jedoch, wenn er aus ihrer Hand	Beauty / Joy
Den leichten Becher nehmen sollte,	Beauty / Joy
So war es beiden allzu schwer:	Beauty / Joy
Denn beide bebten sie so sehr,	Beauty / Joy
Daß keine Hand die andre fand	Beauty / Joy
Und dunkler Wein am Boden rollte.	Beauty / Joy


Die Bürgschaft

Zu Dionys, dem Tyrannen, schlich	Suspense
Damon, den Dolch im Gewande:	Suspense
Ihn schlugen die Häscher in Bande,	Suspense
"Was wolltest du mit dem Dolche? sprich!"	Suspense
Entgegnet ihm finster der Wüterich.	Suspense
"Die Stadt vom Tyrannen befreien!"	Suspense
"Das sollst du am Kreuze bereuen."	Suspense --- Uneasiness

"Ich bin", spricht jener, "zu sterben bereit	Suspense
Und bitte nicht um mein Leben:	Suspense
Doch willst du Gnade mir geben,	Suspense
Ich flehe dich um drei Tage Zeit,	Suspense
Bis ich die Schwester dem Gatten gefreit;	Suspense
Ich lasse den Freund dir als Bürgen,	Suspense
Ihn magst du, entrinn' ich, erwürgen."	Suspense

Da lächelt der König mit arger List	Suspense
Und spricht nach kurzem Bedenken:	Suspense
"Drei Tage will ich dir schenken;	Suspense
Doch wisse, wenn sie verstrichen, die Frist,	Suspense --- Uneasiness
Eh' du zurück mir gegeben bist,	Suspense --- Uneasiness
So muß er statt deiner erblassen,	Suspense --- Uneasiness
Doch dir ist die Strafe erlassen."	Suspense --- Uneasiness

Und er kommt zum Freunde: "Der König gebeut,	Suspense
Daß ich am Kreuz mit dem Leben	Suspense
Bezahle das frevelnde Streben.	Suspense
Doch will er mir gönnen drei Tage Zeit,	Suspense
Bis ich die Schwester dem Gatten gefreit;	Suspense
So bleib du dem König zum Pfande,	Suspense
Bis ich komme zu lösen die Bande."	Suspense

Und schweigend umarmt ihn der treue Freund	Sadness
Und liefert sich aus dem Tyrannen;	Sadness
Der andere ziehet von dannen.	Sadness
Und ehe das dritte Morgenrot scheint,	Beauty / Joy
Hat er schnell mit dem Gatten die Schwester vereint,	Beauty / Joy
Eilt heim mit sorgender Seele,	Beauty / Joy
Damit er die Frist nicht verfehle.	Beauty / Joy

Da gießt unendlicher Regen herab,	Suspense --- Uneasiness
Von den Bergen stürzen die Quellen,	Suspense --- Uneasiness
Und die Bäche, die Ströme schwellen.	Suspense --- Uneasiness
Und er kommt ans Ufer mit wanderndem Stab,	Suspense --- Uneasiness
Da reißet die Brücke der Strudel herab,	Suspense --- Uneasiness
Und donnernd sprengen die Wogen	Suspense --- Uneasiness
Des Gewölbes krachenden Bogen.	Suspense --- Uneasiness

Und trostlos irrt er an Ufers Rand:	Suspense --- Sadness
Wie weit er auch spähet und blicket	Suspense --- Sadness
Und die Stimme, die rufende, schicket.	Suspense --- Sadness
Da stößet kein Nachen vom sichern Strand,	Suspense --- Sadness
Der ihn setze an das gewünschte Land,	Suspense --- Sadness
Kein Schiffer lenket die Fähre,	Suspense --- Sadness
Und der wilde Strom wird zum Meere.	Suspense --- Sadness

Da sinkt er ans Ufer und weint und fleht,	Suspense --- Sadness
Die Hände zum Zeus erhoben:	Suspense --- Sadness
"O hemme des Stromes Toben!	Suspense --- Sadness
Es eilen die Stunden, im Mittag steht	Suspense --- Sadness
Die Sonne, und wenn sie niedergeht	Suspense --- Sadness
Und ich kann die Stadt nicht erreichen,	Suspense --- Sadness
So muß der Freund mir erbleichen."	Suspense --- Sadness

Doch wachsend erneut sich des Stromes Wut,	Suspense --- Uneasiness
Und Welle auf Welle zerrinnet,	Suspense --- Uneasiness
Und Stunde an Stunde ertrinnet.	Suspense --- Uneasiness
Da treibt ihn die Angst, da faßt er sich Mut	Suspense --- Vitality
Und wirft sich hinein in die brausende Flut	Suspense --- Vitality
Und teilt mit gewaltigen Armen	Suspense --- Vitality
Den Strom, und ein Gott hat Erbarmen.	Suspense --- Vitality

Und gewinnt das Ufer und eilet fort	Suspense --- Beauty / Joy
Und danket dem rettenden Gotte;	Suspense --- Beauty / Joy
Da stürzet die raubende Rotte	Suspense --- Uneasiness
Hervor aus des Waldes nächtlichem Ort,	Suspense --- Uneasiness
Den Pfad ihm sperrend, und schnaubert Mord	Suspense --- Uneasiness
Und hemmet des Wanderers Eile	Suspense --- Uneasiness
Mit drohend geschwungener Keule.	Suspense --- Uneasiness

"Was wollt ihr?" ruft er vor Schrecken bleich,	Suspense
"Ich habe nichts als mein Leben,	Suspense
Das muß ich dem Könige geben!"	Suspense
Und entreißt die Keule dem nächsten gleich:	Suspense
"Um des Freundes willen erbarmet euch!"	Suspense
Und drei mit gewaltigen Streichen	Suspense
Erlegt er, die andern entweichen.	Suspense

Und die Sonne versendet glühenden Brand,	Suspense
Und von der unendlichen Mühe	Suspense
Ermattet sinken die Kniee.	Suspense
"O hast du mich gnädig aus Räubershand,	Sadness
Aus dem Strom mich gerettet ans heilige Land,	Sadness
Und soll hier verschmachtend verderben,	Sadness
Und der Freund mir, der liebende, sterben!"	Sadness

Und horch! da sprudelt es silberhell,	Suspense --- Beauty / Joy
Ganz nahe, wie rieselndes Rauschen,	Suspense --- Beauty / Joy
Und stille hält er, zu lauschen;	Suspense --- Beauty / Joy
Und sieh, aus dem Felsen, geschwätzig, schnell,	Beauty / Joy
Springt murmelnd hervor ein lebendiger Quell,	Beauty / Joy
Und freudig bückt er sich nieder	Beauty / Joy
Und erfrischet die brennenden Glieder.	Beauty / Joy

Und die Sonne blickt durch der Zweige Grün	Beauty / Joy
Und malt auf den glänzenden Matten	Beauty / Joy
Der Bäume gigantische Schatten;	Beauty / Joy
Und zwei Wanderer sieht er die Straße ziehn,	Suspense
Will eilenden Laufes vorüber fliehn,	Suspense
Da hört er die Worte sie sagen:	Suspense
"Jetzt wird er ans Kreuz geschlagen."	Suspense --- Uneasiness

Und die Angst beflügelt den eilenden Fuß,	Suspense --- Uneasiness
Ihn jagen der Sorge Qualen;	Suspense --- Uneasiness
Da schimmern in Abendrots Strahlen	Suspense
Von ferne die Zinnen von Syrakus,	Suspense
Und entgegen kommt ihm Philostratus,	Suspense
Des Hauses redlicher Hüter,	Suspense
Der erkennet entsetzt den Gebieter:	Suspense

"Zurück! du rettest den Freund nicht mehr,	Sadness
So rette das eigene Leben!	Sadness
Den Tod erleidet er eben.	Sadness
Von Stunde zu Stunde gewartet' er	Sadness
Mit hoffender Seele der Wiederkehr,	Sadness
Ihm konnte den mutigen Glauben	Sadness
Der Hohn des Tyrannen nicht rauben."	Sadness

"Und ist es zu spät, und kann ich ihm nicht,	Sadness
Ein Retter, willkommen erscheinen,	Sadness
So soll mich der Tod ihm vereinen.	Sadness
Des rühme der blut'ge Tyrann sich nicht,	Sadness
Daß der Freund dem Freunde gebrochen die Pflicht,	Sadness
Er schlachte der Opfer zweie	Sadness
Und glaube an Liebe und Treue!"	Sadness

Und die Sonne geht unter, da steht er am Tor,	Suspense --- Uneasiness
Und sieht das Kreuz schon erhöhet,	Suspense --- Uneasiness
Das die Menge gaffend umstehet;	Suspense --- Uneasiness
An dem Seile schon zieht man den Freund empor,	Suspense --- Uneasiness
Da zertrennt er gewaltig den dichter Chor:	Suspense
"Mich, Henker", ruft er, "erwürget!	Suspense
Da bin ich, für den er gebürget!"	Suspense

Und Erstaunen ergreifet das Volk umher,	Beauty / Joy
In den Armen liegen sich beide	Beauty / Joy
Und weinen vor Schmerzen und Freude.	Beauty / Joy
Da sieht man kein Augen tränenleer,	Beauty / Joy
Und zum Könige bringt man die Wundermär';	Beauty / Joy
Der fühlt ein menschliches Rühren,	Beauty / Joy
Läßt schnell vor den Thron sie führen,	Beauty / Joy

Und blicket sie lange verwundert an.	Beauty / Joy
Drauf spricht er: "Es ist euch gelungen,	Beauty / Joy
Ihr habt das Herz mir bezwungen;	Beauty / Joy
Und die Treue, sie ist doch kein leerer Wahn -	Beauty / Joy
So nehmet auch mich zum Genossen an:	Beauty / Joy
Ich sei, gewährt mir die Bitte,	Beauty / Joy
In eurem Bunde der dritte!"	Beauty / Joy


Tränen des Vaterlandes / Anno 1636

Wir sind doch nunmehr ganz, ja mehr denn ganz verheeret!	Annoyance
Der frechen Völker Schar, die rasende Posaun	Annoyance
Das vom Blut fette Schwert, die donnernde Karthaun	Annoyance
Hat aller Schweiß, und Fleiß, und Vorrat aufgezehret.	Annoyance

Die Türme stehn in Glut, die Kirch' ist umgekehret.	Sadness
Das Rathaus liegt im Grauß, die Starken sind zerhaun,	Sadness
Die Jungfern sind geschänd't, und wo wir hin nur schaun	Sadness --- Uneasiness
Ist Feuer, Pest, und Tod, der Herz und Geist durchfähret.	Sadness --- Uneasiness

Hier durch die Schanz' und Stadt rinnt allzeit frisches Blut.	Uneasiness
Dreimal sind schon sechs Jahr, als unser Ströme Flut	Uneasiness
Von Leichen fast verstopft, sich langsam fort gedrungen.	Uneasiness

Doch schweig' ich noch von dem, was ärger als der Tod,	Sadness
Was grimmer denn die Pest, und Glut und Hungersnot,	Sadness
Das auch der Seelen Schatz, so vielen abgezwungen.	Sadness


Vorfrühling

Pralle Wolken jagen sich in Pfützen	Beauty / Joy
Aus frischen Leibesbrüchen schreien Halme Ströme	Beauty / Joy
Die Schatten stehn erschöpft.	Beauty / Joy
Auf kreischt die Luft	Uneasiness
Im Kreisen, weht und heult und wälzt sich	Uneasiness
Und Risse schlitzen jählings sich	Uneasiness
und narben	Uneasiness
Am grauen Leib.	Uneasiness
Das Schweigen tappet schwer herab	Uneasiness
Und lastet!	Uneasiness
Da rollt das Licht sich auf	Uneasiness
Jäh gelb und springt	Uneasiness
Und Flecken spritzen -	Uneasiness
Verbleicht	Uneasiness
Und	Beauty / Joy
Pralle Wolken tummeln sich in Pfützen.	Beauty / Joy


Lover's Seat

Im Abend sind wir steile	Beauty / Joy
grünbebuschte Dünenwege hingeschritten.	Beauty / Joy
Du ruhst an mich gedrängt.	Beauty / Joy
Die Kreideklippe schwingt ihr schimmerndes Gefieder	Beauty / Joy
über tiefem Meere.	Beauty / Joy
Hier, wo der Fels	Beauty / Joy
in jäher Todesgier ins Leere	Beauty / Joy
Hinüberlehnt, sind einst zwei Liebende	Beauty / Joy
ins weiche blaue Bett geglitten.	Beauty / Joy

Fern tönt die Brandung.	Beauty / Joy
Zwischen Küssen lausch ich der Legende,	Beauty / Joy
Die lachend mir dein Mund	Beauty / Joy
in den erglühten Sommerabend spricht.	Beauty / Joy
Doch tief mich beugend	Sadness
seh' ich wie im Glück erstarren dein Gesicht	Sadness
Und dumpfe Schwermut	Sadness
hinter deinen Wimpern warten und das nahe Ende.	Sadness


Kriegslied

Empor mein Volk! Das Schwert zur Hand!	Suspense
Und brich hervor in Haufen!	Suspense
Vom heil’gen Zorn ums Vaterland	Annoyance
Mit Feuer laß dich taufen!	Annoyance
Der Erbfeind beut dir Schmach und Spott,	Annoyance
Das Maß ist voll, zur Schlacht mit Gott!	Annoyance
Vorwärts!	Annoyance

Dein Haus in Frieden auszubau’n	Annoyance
Stand all dein Sinn und Wollen,	Annoyance
Da bricht den Hader er vom Zaun	Annoyance
Von Gift und Neid geschwollen.	Annoyance
Komm über ihn und seine Brut	Annoyance --- Uneasiness
Das frevelhaft vergossne Blut!	Annoyance --- Uneasiness
Vorwärts!	Annoyance --- Uneasiness

Wir träumen nicht von raschem Sieg,	Annoyance
Von leichten Ruhmeszügen,	Annoyance
Ein Weltgericht ist dieser Krieg	Annoyance
Und stark der Geist der Lügen.	Annoyance
Doch der einst unsrer Väter Burg,	Annoyance
Getrost, er führt auch uns hindurch!	Annoyance
Vorwärts!	Annoyance

Schon läßt er klar bei Tag und Nacht	Annoyance
Uns seine Zeichen schauen,	Annoyance
Die Flammen hat er angefacht	Annoyance
In allen deutschen Gauen.	Annoyance
Von Stamm zu Stamme lodert's fort:	Annoyance
Kein Mainstrom mehr, kein Süd und Nord!	Annoyance
Vorwärts!	Annoyance

Voran denn, kühner Preußenaar,	Annoyance
Voran durch Schlacht und Grausen!	Annoyance
Wie Sturmwind schwellt dein Flügelpaar	Annoyance
Vom Himmel her ein Brausen,	Annoyance
Das ist des alten Blüchers Geist,	Annoyance
Der dir die rechte Straße weist.	Annoyance
Vorwärts!	Annoyance

Flieg, Adler, flieg! Wir stürmen nach,	Annoyance
Ein einig Volk in Waffen.	Annoyance
Wir stürmen nach, ob tausendfach	Annoyance
Des Todes Pforten klaffen.	Annoyance
Und fallen wir: flieg Adler, flieg!	Annoyance
Aus unsrem Blute wächst der Sieg.	Annoyance
Vorwärts!	Annoyance


Der Panther

Sein Blick ist vom Vorübergehn der Stäbe	Sadness
so müd geworden, dass er nichts mehr hält.	Sadness
Ihm ist, als ob es tausend Stäbe gäbe	Sadness
und hinter tausend Stäben keine Welt.	Sadness

Der weiche Gang geschmeidig starker Schritte,	Sadness --- Annoyance
der sich im allerkleinsten Kreise dreht,	Sadness --- Annoyance
ist wie ein Tanz von Kraft um eine Mitte,	Sadness --- Annoyance
in der betäubt ein großer Wille steht.	Sadness --- Annoyance

Nur manchmal schiebt der Vorhang der Pupille	Sadness
sich lautlos auf -. Dann geht ein Bild hinein,	Sadness
geht durch der Glieder angespannte Stille -	Sadness
und hört im Herzen auf zu sein.	Sadness


Aus alten Märchen winkt es

Aus alten Märchen winkt es	Nostalgia --- Beauty / Joy
Hervor mit weißer Hand,	Nostalgia --- Beauty / Joy
Da singt es und da klingt es	Nostalgia --- Beauty / Joy
Von einem Zauberland:	Nostalgia --- Beauty / Joy

Wo große Blumen schmachten	Beauty / Joy
Im goldnen Abendlicht,	Beauty / Joy
Und zärtlich sich betrachten	Beauty / Joy
Mit bräutlichem Gesicht; -	Beauty / Joy

Wo alle Bäume sprechen	Beauty / Joy
Und singen, wie ein Chor,	Beauty / Joy
Und laute Quellen brechen	Beauty / Joy
Wie Tanzmusik hervor; -	Beauty / Joy

Und Liebesweisen tönen,	Beauty / Joy
Wie du sie nie gehört,	Beauty / Joy
Bis wundersüßes Sehnen	Beauty / Joy
Dich wundersüß betört!	Beauty / Joy

Ach, könnt ich dorthin kommen,	Nostalgia --- Beauty / Joy
Und dort mein Herz erfreun,	Nostalgia --- Beauty / Joy
Und aller Qual entnommen,	Nostalgia --- Beauty / Joy
Und frei und selig sein!	Nostalgia --- Beauty / Joy

Ach! jenes Land der Wonne,	Nostalgia --- Beauty / Joy
Das seh ich oft im Traum;	Nostalgia --- Beauty / Joy
Doch kommt die Morgensonne,	Nostalgia --- Sadness
Zerfließts wie eitel Schaum.	Nostalgia --- Sadness


Lockung

Hörst du nicht die Bäume rauschen	Beauty / Joy
Draußen durch die stille Rund?	Beauty / Joy
Lockts dich nicht, hinabzulauschen	Beauty / Joy
Von dem Söller in den Grund,	Beauty / Joy
Wo die vielen Bäche gehen	Beauty / Joy
Wunderbar im Mondenschein	Beauty / Joy
Und die stillen Schlösser sehen	Beauty / Joy
In den Fluß vom hohen Stein?	Beauty / Joy

Kennst du noch die irren Lieder	Nostalgia --- Beauty / Joy
Aus der alten, schönen Zeit?	Nostalgia --- Beauty / Joy
Sie erwachen alle wieder	Nostalgia --- Beauty / Joy
Nachts in Waldeseinsamkeit,	Nostalgia --- Beauty / Joy
Wenn die Bäume träumend lauschen	Beauty / Joy
Und der Flieder duftet schwül	Beauty / Joy
Und im Fluß die Nixen rauschen –	Beauty / Joy
Komm herab, hier ists so kühl.	Vitality


